go get -u -v github.com/nsf/gocode // 自动补全	 
go get -u -v github.com/uudashr/gopkgs/cmd/gopkgs // 自动补全未导入的包	 
go get -u -v github.com/ramya-rao-a/go-outline // 当前文件中按符号搜索	https://github.com/golang/tools
go get -u -v github.com/acroca/go-symbols // 当前workspace中按符号搜索	 
go get -u -v golang.org/x/tools/cmd/guru // 查找所有引用组件	 
go get -u -v golang.org/x/tools/cmd/gorename // 重命名符号	 
go get -u -v github.com/fatih/gomodifytags // 修改结构上的标签	 
go get -u -v github.com/haya14busa/goplay/cmd/goplay // for running current file in the Go playground	 
go get -u -v github.com/josharian/impl // for generating stubs for interfaces	 
go get -u -v github.com/davidrjenni/reftools/cmd/fillstruct // for filling a struct literal with default values	 
go get -u -v github.com/rogpeppe/godef // 转到定义2	 
go get -u -v golang.org/x/tools/cmd/godoc // 鼠标悬停显示文档注释2	 
go get -u -v sourcegraph.com/sqs/goreturns // 格式化代码2	 
go get -u -v github.com/golang/lint/golint // for linting	https://github.com/golang/lint
go get -u -v github.com/cweill/gotests/... // 生成单元测试	 
go get -u -v github.com/derekparker/delve/cmd/dlv // 调试	 
go get -u -v github.com/zmb3/gogetdoc // 转到定义2/鼠标悬停显示注释2	 
go get -u -v golang.org/x/tools/cmd/goimports // 格式化代码2	 

bin/ 目录下主要包括以下几个工具：
dlv.exe	        // go语言调试工具
gocode.exe	    // go语言代码检查，自动补全
godef.exe 	    // go语言代码定义和引用的跳转
golint.exe 	    // go语言代码规范检查
go-outline.exe 	// 用于在Go源文件中提取JSON形式声明的简单工具
gopkgs.exe 	    // 快速列出可用包的工具
gorename.exe 	// 在Go源代码中执行标识符的精确类型安全重命名
goreturns.exe 	// 类似fmt和import的工具，使用零值填充Go返回语句以匹配func返回类型
go-symbols.exe 	// 从go源码树中提取JSON形式的包符号的工具
gotour.exe 	    // go语言指南网页版
guru.exe 	    // go语言源代码有关工具，如代码高亮等

gen.exe
gin.exe // 热加载
gocode-gomod.exe
godef-gomod.exe
gopls.exe
gotype-live.exe
tour.exe // go学习基础